111111111111111111111111111111111111111111111111111111111111
100000000000010000000000000000000000001000000000000000000001
100000000000010000000000000000000000001000000000000000000001
100000000000010000000000000000000000001000000000000000000001
100000000000010000000000000000000000001000000000000000000001
100001111111111111111111111111100011111000011111111111110001
100001000000000000000000000000000000001000010000010000010001
100001000000000000000000000000000000001000010000010000010001
100001000000000000000000000000000000001000010000010000010001
100001000000000000000000000000000000001000000000010000010001
100001111111111111111111111000011111111000000000010000010001
100000000000000000100000000000000000000000000000010000000001
100000000000000000100000000000000000000000000000010000000001
100000000000000000100000000000000000000000000000010000000001
100000000000000000100000000000000001111111000000010000000001
100011111111110000111111111100000000000000000000010000010001
100010000000010000000000000000000000000000000000000000010001
100010000000010000000000000000000000000000000000000000010001
100010000000010000000000000000000000000000000000000000010001
100010000000010000001000000000111111100001111111100000010001
100011111000010000001111111000000000000000000000000000010001
100010000000010000001000000000000000000000000000000000010001
100010000000010000001000000000000000000000000000000000010001
100010000000011111111000000000000000000000000000000000010001
100000000000000000001000000000000000000000000000000000010001
100000000000000000001000010000111111111111100001000011110001
100000000000000000001000010000100000000000000001000000000001
100000000000000000001000010000100000000000000001000000000001
100000000000000000001000010000100000000000000001000000000001
111111111111111111111111111111111111111111111111111111111111